###########
# H       #
#         #
#         #
#         #
#         #
#         #
###########
