###################################################
#H                                                #
#                                                 #
#                                                 #
#                                                 #
#                                                 #
#                                                 #
#                                                 #
#                                                 #
#                                                 #
#                                                 #
###################################################
