###################
#        #        #
# ## ### # ### ## #
#                 #
# ## # ##### # ## #
#    #   #   #    #
#### ### # ### ####
#  # #       # #  #
#### # ## ## # ####
#      #$$$#      #
#### # ##### # ####
#  # #       # #  #
#### # ##### # ####
#        #        #
# ## ### # ### ## #
#  #     H     #  #
## # # ##### # # ##
#    #   #   #    #
# ###### # ###### #
#                 #
###################
