𐌇𐌇𐌇𐌇𐌇𐌇𐌇𐌇𐌇𐌇𐌇𐌇𐌇𐌇𐌇𐌇𐌇𐌇𐌇𐌇𐌇𐌇𐌇𐌇𐌇𐌇𐌇𐌇𐌇𐌇𐌇𐌇𐌇𐌇𐌇𐌇𐌇𐌇𐌇𐌇𐌇𐌇𐌇𐌇𐌇𐌇𐌇𐌇𐌇𐌇
𐌇                         H                      𐌇
𐌇                                                𐌇
𐌇                                                𐌇
𐌇    𐌇𐌇𐌇𐌇𐌇𐌇𐌇𐌇𐌇 𐌇𐌇𐌇𐌇𐌇𐌇𐌇𐌇                          𐌇
𐌇        𐌇       𐌇                               𐌇
𐌇        𐌇       𐌇                               𐌇
𐌇        𐌇       𐌇                               𐌇
𐌇    𐌇𐌇𐌇𐌇𐌇𐌇𐌇𐌇𐌇 𐌇𐌇𐌇𐌇𐌇𐌇𐌇𐌇                          𐌇
𐌇                                                𐌇
𐌇                                                𐌇
𐌇                                                𐌇
𐌇                                                𐌇
𐌇                                                𐌇
𐌇                                                𐌇
𐌇                                                𐌇
𐌇                                                𐌇
𐌇                                                𐌇
𐌇                                                𐌇
𐌇                                                𐌇
𐌇                                                𐌇
𐌇                                                𐌇
𐌇𐌇𐌇𐌇𐌇𐌇𐌇𐌇𐌇𐌇𐌇𐌇𐌇𐌇𐌇𐌇𐌇𐌇𐌇𐌇𐌇𐌇𐌇𐌇𐌇𐌇𐌇𐌇𐌇𐌇𐌇𐌇𐌇𐌇𐌇𐌇𐌇𐌇𐌇𐌇𐌇𐌇𐌇𐌇𐌇𐌇𐌇𐌇𐌇𐌇
