##################################################
#                         H                      #
#                                                #
#                                                #
#    ######### ########                          #
#        #       #                               #
#        #       #                               #
#        #       #                               #
#    ######### ########                          #
#                                                #
#                                                #
#                                                #
#                                                #
#                                                #
#                                                #
#                                                #
#                                                #
#                                                #
#                                                #
#                                                #
#                                                #
#                                                #
##################################################
