##################################################
#H                                               #
#                                ##### ###########
#                                                #
#                         ############ ###########
#  #######                                       #
#                                ##### ###########
#  #### ##                        #        #     #
#                                          #     #
#  #  #                           #        #     #
#  #  #                          ##### ####### ###
#  #  #                                          #
#                                #################
#  #  #                                          #
#  #  #                          #################
#  #  #                                          #
## #                             ######## ########
#                              $$$$$$$           #
#                              $                 #
##################################################
