##################################################
#H                                               #
#  ############### ################### ###########
#                                                #
#    ######### ########   ############ ###########
#  #######       #                               #
#                #  ################## ###########
#  #### ##       #                #        #     #
#  #    ###### ########                    #     #
#  #  #                           #        #     #
#  #  #  ############ ########## ##### ####### ###
#  #  #                                          #
#        ############ ########## #################
#  #  #                                          #
#  #  #  ############ ########## #################
#  #  #                                          #
## #  ############### ########## ######## ########
#                                                #
#                                              $ #
##################################################
