###########
#         #
#         #
#         #
#         #
#         #
#  H      #
###########
